000000000000000000000000000000000000000000000000000300300000000000000000000000000000000000000000000000000000000000000000000000000000000022222000000000003000300030000000000000000000000000000000000000000000000000
000000000000000000000000000000000000000000000000000000000000000000000000000000000000000000000000000000000000000000000000000000000000000022222000000111111111111111111111111111111111111111111111111111111111111111
000000000000000000000000000000000000000000040000011111111440000000000000000000000000000000000000000000000000000000000000000000000000000022222000004000000000000000000000000000000000000000000000000000000002222222
000000000000000000000000000000000000000000000000020000002000000000000000000000000000000000000000000000000000000000000000000000000000000022222000000000000000000000000000000000000000000000000000000000000002222222
000000000000000000000000000000000000000000000000020000000000000000000000000000000000000000000000000000000000000000000000000000000000000022222000000000000000000000000000003000000000003000000000000000000002222222
000000000000000000000000000000000000000000000000420000000000000000000033000000000000000000000000000000000000000000000000000000000000000022222400000000000000000000000000000000000000000000000000000000300002222222
000000000000000000000000000000000000000000000000020000000000000000000050000000000000000000000000000000000000000000000000000000000000000022222000000000000000004000004000004000004000004000000400000003030002222222
000000000000000000000000000000000000000000000000020000001100000000011111111000000000000000000000000000000000000000000000000000000000000022222000000000000000000000000000000000000000000000000000000000000002222222
000000000000000000000000000000000000000000040000020000042200000000022222222000000000000000000000000000000000000000000000000000000000000022222222222444000000000000000000000000000000000000000000000000500002222222
000000000000000000000000000000000000000000000000020000002200000000022222222000000000000000000000000000000000000000000000000000000000000022222222222000000000000000000000000000000000000000000000004222222222222222
000000000000000003000003000000000000000000000000024000002200000000022222222000000000000000000000000000000000000000000000000000000000000022222222222000000000000000000000000040004000004000004000000222222222222222
000000000000000000000000000000000000000000000000420000002200000000022222222000000000000000000000000000000000000000000000000000000000000022222222222000000000000000000004000000000000000000000000000200000002222222
000000000000000000000000000000000050005000000000020000042200000000022222222000000000000000000000000000000000000000000000000000000000000022222222222000000000000000400000000000000000000000000000000200030002222222
000000000000000444444444400044444444444444440000020000002200000000022222222000000000000000000000000000000000000000000000000000000000000022222222222000000000040000000000000000000000000000000000000203030302222222
000000000000000000000000000000000000000000000000024000002200000000022222222000000000000000000000000000000000000000000000000000000000000022222222222000000000000000030000000000000000000000000000000000000002222222
000000000000000000000000000000000000000000000000020000002200000000022222222000000000000000000000000000000000000000000000000000000000000022222222222000000000000000000000000002222220000000000000000000000002222222
000000000000000000000000040000003000000000000000023000042200000000022222222000000030000000000000000000000000000000000000000000000000000022222222222000000020000000000000000022222222000000000000500000000002222222
000000000000000000000000000400000000000000000000020000002200000000022222222000000000000000000000000000000000000000000000000000000000000022222222222000000422222222222222222222222222222222222222222222222222222222
000000000000000000000000000000004000000000000000024000002200000000022222222000000111100044400000044000011111100000000000000000000000000022222222222000000000000000000000000000000000000000000000000000000222222222
000000000000000000000000000000000000040000010000020000002200000000002222222000001222200000000000000000422222210000000000000000000000000022222222222000000000000000000000000003000000000000000000000000000222222222
000000000000000000000000000000000000000000120000000000042200000000000002222000012222200000000000000300022222201000000000000000000000000022222222222000200000000000000000005000000000000000000200000000000222222222
000000000000000000000000000000000000000001220000000000002200000000000000000000122222200000000000000000022222222100000000004444000000000022222222222222222222222222222222222222222222222222222240000000000222222222
000303000000000000000003000003000000000012224444444000002200000220000000000001222222200000000000011111122222222210000000000000000000000000000000000000000000000000000000000000000000000000000000000000000222222222
000000000000000000000000000000000000000122220000000000002003002222000000000012222222200000000000022222222222222221000000000000000000000000000000000000000000000000000000000000000000000000000000000000300222222222
000000000000000050000000000000010050001222220000000000002000022222200050000122222222200000000000022222222222222222105005000500000000000500000000000000000000000000000000300000000000000000000000000200500222222222
111111111111111111111111111000021111112222220000000000002222222222222222222222222222200000000000022222222222222222211111111111100000222222222222222220000002222222000000000000002222222222222222222222222222222222
222222222222222222222222222000022222222222220000000000002222222222222222222222222222200000000000022222222222222222222222222222200000222222222222222220000002222222222000000002222222222222222222222222222222222222
222222222222222222222222222000022222222222220000000000002222222222222222222222222222200000000000022222222222222222222222222222200000222222222222222220005002222222222222002222222222222222222222222222222222222222
222222222222222222222222222000022222222222220000000000002222222222222222222222222222200000000000022222222222222222222222222222200000222222222222222222222222222222222222222222222222222222222222222222222222222222
222222222222222222222222222000022222222222220000000000002222222222222222222222222222200000000000022222222222222222222222222222200000222222222222222222222222222222222222222222222222222222222222222222222222222222
222222222222222222222222222000022222222222220000000000002222222222222222222222222222200000000000022222222222222222222222222222200000222222222222222222222222222222222222222222222222222222222222222222222222222222
