000000000000000000000000000000000000000000000000
000000000000000000000000000000000000000000000000
000000000000000000000000000000000000000000000000
000000000000000000030000000033000000000000000000
000000000000000000000000000000000000000000000000
000000000030030000301030030111110303030303030300
000000300300300000302003000030000030000300003000
000000000000000000002000000000000000000000000000
111111111111111111112111111111111111111111111111
222222222222222222222222222222222222222222222222
222222222222222222222222222222222222222222222222
222222222222222222222222222222222222222222222222